{
    "name": "level3",
    "next_level": "level4",
    "size": {"width":3200,"height":1000},
    "block_size": {"width":80,"height":25},
    "array": [
            [213,213,213,213,213,213,213,213,213,213,213,213,213,213,213,213,213,213,213,213,213,213,213,213,213,213,213,213,213,213,213,213,213,213,213,213,213,213,213,213,213,213,213,213,213,213,213,213,213,213,213,213,213,213,213,213,213,213,213,213,213,213,213,213,213,213,213,213,213,213,213,213,213,213,213,213,213,213,213,213],
            [213, -1, -1, -1, -1, -1, -1, -1, -1, -1, -1, -1, -1, -1, -1, -1, -1, -1, -1, -1, -1, -1, -1, -1, -1, -1, -1, -1, -1, -1, -1, -1, -1, -1, -1, -1, -1, -1, -1, -1, -1, -1, -1, -1, -1, -1,213, -1, -1, -1, -1,213, -1, -1, -1, -1, -1, -1, -1, -1, -1, -1, -1, -1, -1, -1, -1, -1, -1, -1, -1, -1, -1, -1, -1, -1, -1, -1, -1,213],
            [213, -1, -1, -1, -1, -1, -1, -1, -1, -1, -1, -1, -1, -1, -1, -1, -1, -1, -1, -1, -1, -1, -1, -1, -1, -1, -1, -1, -1, -1, -1, -1, -1, -1, -1, -1, -1, -1, -1, -1, -1, -1, -1, -1, -1, -1,213, -1, -1, -1, -1, -1, -1, -1, -1, -1, -1, -1, -1, -1, -1, -1, -1, -1, -1, -1, -1, -1, -1, -1, -1, -1, -1, -1, -1, -1, -1, -1, -1,213],
            [213, -1, -1, -1, -1, -1, -1, -1, -1, -1, -1, -1, -1, -1, -1, -1, -1, -1, -1, -1, -1, -1, -1, -1, -1, -1, -1, -1, -1, -1, -1, -1, -1, -1, -1, -1, -1, -1, -1, -1, -1, -1, -1, -1, -1, -1,213, -1, -1, -1, -1, -1, -1, -1, -1, -1, -1, -1, -1, -1, -1, -1, -1, -1, -1, -1, -1, -1, -1, -1, -1, -1, -1, -1, -1, -1, -1, -1, -1,213],
            [213, -1, -1, -1, -1, -1, -1, -1, -1, -1, -1, -1, -1, -1, -1, -1, -1, -1, -1, -1, -1, -1, -1, -1, -1, -1, -1, -1, -1, -1, -1, -1, -1, -1, -1, -1, -1, -1, -1, -1, -1, -1, -1, -1, -1, -1,213, -1, -1, -1, -1, -1, -1, -1, -1, -1, -1, -1, -1, -1, -1, -1, -1, -1, -1, -1, -1, -1, -1, -1, -1, -1, -1, -1, -1, -1, -1, -1, -1,213],
            [213, -1, -1, -1, -1, -1, -1, -1, -1, -1, -1, -1, -1, -1, -1, -1, -1, -1, -1, -1, -1, -1, -1, -1, -1, -1, -1, -1, -1, -1, -1, -1, -1, -1, -1, -1, -1, -1, -1, -1, -1, -1, -1, -1, -1, -1,213, -1, -1, -1, -1, -1, -1, -1, -1, -1, -1, -1, -1, -1, -1, -1, -1, -1, -1, -1, -1, -1, -1, -1, -1, -1, -1, -1, -1, -1, -1, -1, -1,213],
            [213, -1, -1, -1, -1, -1, -1, -1,213,213,213,213,213,213,213,213, -1, -1, -1, -1, -1, -1, -1, -1, -1, -1, -1, -1, -1, -1, -1, -1, -1, -1, -1,213,213,213,213,213,213,213,213,213, -1, -1,213, -1, -1, -1, -1,213, -1, -1, -1, -1, -1, -1, -1, -1, -1, -1, -1, -1, -1, -1, -1, -1, -1, -1, -1, -1, -1, -1, -1, -1, -1, -1, -1,213],
            [213, -1, -1, -1, -1, -1, -1, -1,213,213, -1, -1, -1, -1,213, -1, -1, -1, -1, -1, -1, -1, -1, -1, -1, -1, -1, -1, -1, -1, -1, -1, -1, -1, -1,213, -1, -1, -1, -1, -1, -1, -1, -1, -1, -1,213,213,213,213,213,213, -1, -1, -1,213,213,213,213, -1, -1, -1, -1, -1, -1, -1, -1, -1, -1, -1, -1, -1, -1, -1, -1, -1, -1, -1, -1,213],
            [213, -1, -1, -1, -1,213,213,213,213,213, -1, -1, -1, -1,213, -1, -1, -1, -1, -1, -1, -1, -1, -1, -1, -1, -1, -1, -1, -1, -1,213,213,213,213,213, -1, -1, -1, -1, -1, -1, -1, -1, -1, -1,213, -1, -1, -1, -1, -1, -1, -1, -1, -1, -1, -1, -1, -1, -1,213,213,213,213,213,213,213,213, -1, -1, -1, -1, -1, -1, -1, -1, -1, -1,213],
            [213, -1, -1, -1, -1, -1, -1, -1,213,213, -1, -1, -1, -1,213, -1, -1, -1, -1, -1, -1, -1, -1, -1, -1, -1, -1, -1, -1, -1, -1,213, -1, -1, -1, -1, -1, -1, -1, -1, -1, -1, -1, -1, -1, -1,213, -1, -1, -1, -1, -1, -1, -1, -1, -1, -1, -1, -1, -1, -1, -1, -1, -1, -1, -1, -1, -1,213, -1, -1, -1, -1, -1, -1, -1, -1, -1, -1,213],
            [213, -1, -1, -1, -1, -1, -1, -1,213,213, -1, -1, -1, -1,213, -1, -1, -1, -1, -1, -1, -1, -1, -1, -1, -1, -1, -1, -1, -1, -1,213, -1, -1, -1, -1, -1, -1, -1, -1, -1, -1, -1, -1, -1, -1,213, -1, -1, -1, -1, -1, -1, -1, -1, -1, -1, -1, -1, -1, -1, -1, -1, -1, -1, -1, -1, -1,213,213,213,213, -1, -1, -1, -1, -1, -1, -1,213],
            [213, -1, -1, -1, -1, -1, -1, -1,213,213, -1, -1, -1, -1,213, -1, -1, -1, -1, -1, -1, -1, -1, -1, -1, -1, -1, -1, -1, -1, -1,213, -1, -1, -1, -1, -1, -1, -1, -1, -1, -1, -1, -1, -1, -1,213, -1, -1, -1, -1, -1, -1, -1, -1, -1, -1, -1, -1, -1, -1, -1, -1, -1, -1, -1, -1, -1, -1, -1, -1, -1, -1, -1, -1, -1, -1, -1, -1,213],
            [213,213,213,213, -1, -1, -1, -1,213,213, -1, -1, -1, -1,213, -1, -1, -1, -1, -1, -1, -1, -1, -1, -1, -1, -1, -1,213, -1, -1,213, -1, -1, -1, -1, -1, -1, -1, -1, -1, -1, -1, -1, -1, -1,213, -1, -1, -1, -1, -1, -1, -1, -1, -1, -1, -1, -1, -1, -1, -1, -1, -1, -1, -1, -1, -1, -1, -1, -1, -1, -1, -1, -1, -1, -1, -1, -1,213],
            [213, -1, -1, -1, -1, -1, -1, -1,213,213, -1, -1, -1, -1,213, -1, -1, -1, -1, -1, -1, -1, -1, -1, -1, -1, -1, -1,213, -1, -1,213, -1, -1, -1, -1,213,213,213,213,213,213,213,213,213,213,213, -1, -1, -1, -1, -1, -1, -1, -1, -1, -1, -1, -1, -1, -1, -1, -1, -1, -1, -1, -1, -1, -1, -1, -1, -1, -1, -1, -1, -1, -1, -1, -1,213],
            [213, -1, -1, -1, -1, -1, -1, -1,213,213, -1, -1,213,213,213, -1, -1, -1, -1, -1, -1, -1, -1, -1, -1,213, -1, -1,213, -1, -1,213, -1, -1, -1, -1,213, -1, -1, -1, -1, -1, -1, -1, -1, -1, -1, -1, -1, -1, -1, -1, -1, -1, -1, -1, -1, -1, -1, -1, -1, -1, -1, -1, -1, -1, -1, -1, -1, -1, -1, -1, -1, -1,213,213,213,213,213,213],
            [213, -1, -1, -1, -1, -1, -1, -1,213,213, -1, -1, -1, -1, -1, -1, -1, -1, -1, -1, -1, -1, -1, -1, -1,213, -1, -1,213, -1, -1,213, -1, -1,213,213,213, -1, -1, -1, -1, -1, -1, -1, -1, -1, -1, -1, -1, -1, -1, -1, -1, -1, -1, -1, -1, -1, -1, -1, -1, -1, -1, -1, -1, -1, -1, -1, -1, -1, -1, -1, -1, -1, -1, -1, -1, -1, -1,213],
            [213, -1, -1, -1, -1,213,213,213,213,213, -1, -1, -1, -1, -1, -1, -1, -1, -1, -1, -1, -1, -1, -1, -1,213, -1, -1,213, -1, -1,213, -1, -1, -1, -1, -1, -1, -1, -1, -1, -1, -1, -1, -1, -1, -1, -1, -1, -1, -1, -1, -1, -1, -1, -1, -1, -1, -1, -1, -1, -1, -1, -1, -1, -1, -1, -1, -1, -1, -1, -1, -1, -1, -1, -1, -1, -1, -1,213],
            [213, -1, -1, -1, -1, -1, -1, -1,213,213, -1, -1, -1, -1, -1, -1, -1, -1, -1, -1, -1, -1,213, -1, -1,213, -1, -1,213, -1, -1,213, -1, -1, -1, -1, -1, -1, -1, -1, -1, -1, -1, -1, -1, -1, -1, -1, -1, -1, -1, -1, -1, -1, -1, -1, -1, -1, -1, -1, -1, -1, -1, -1, -1,213,213,213,213,213,213,213,213, -1, -1, -1, -1, -1, -1,213],
            [213, -1, -1, -1, -1, -1, -1, -1,213,213, -1, -1, -1, -1, -1, -1, -1, -1, -1, -1, -1, -1,213, -1, -1,213, -1, -1,213, -1, -1,213, -1, -1, -1, -1, -1, -1, -1, -1, -1, -1, -1, -1, -1, -1, -1, -1, -1, -1, -1, -1, -1, -1, -1, -1, -1, -1, -1, -1, -1, -1, -1, -1, -1,213, -1, -1, -1, -1, -1, -1, -1, -1, -1, -1, -1, -1, -1,213],
            [213, -1, -1, -1, -1, -1, -1, -1,213,213, -1, -1, -1, -1, -1, -1, -1, -1, -1, -1, -1, -1,213, -1, -1,213, -1, -1,213, -1, -1,213, -1, -1, -1, -1, -1, -1, -1, -1, -1, -1, -1, -1, -1, -1, -1, -1, -1, -1, -1, -1, -1, -1, -1, -1, -1, -1, -1, -1,213,213,213,213,213,213, -1, -1, -1, -1, -1, -1, -1, -1, -1, -1, -1, -1, -1,213],
            [213,213,213,213, -1, -1, -1, -1,213,213,213,213,213,213,213, -1, -1, -1, -1,213, -1, -1,213, -1, -1,213, -1, -1,213, -1, -1,213, -1, -1, -1, -1, -1, -1, -1, -1, -1, -1, -1, -1, -1, -1, -1, -1, -1, -1, -1, -1, -1, -1, -1, -1, -1, -1, -1, -1, -1, -1, -1, -1, -1, -1, -1, -1, -1, -1, -1, -1, -1, -1, -1, -1, -1, -1, -1,213],
            [213, -1, -1, -1, -1, -1, -1, -1,213,213, -1, -1, -1, -1, -1, -1, -1, -1, -1,213, -1, -1,213, -1, -1,213, -1, -1,213, -1, -1,213, -1, -1, -1, -1, -1, -1, -1, -1, -1, -1, -1, -1, -1, -1, -1, -1,213,213,213,213,213,213,213,213,213,213, -1, -1, -1, -1, -1, -1, -1, -1, -1, -1, -1, -1, -1, -1, -1, -1, -1, -1, -1, -1, -1,213],
            [213, -1, -1, -1, -1, -1, -1, -1,213,213, -1, -1, -1, -1, -1, -1, -1, -1, -1,213, -1, -1,213, -1, -1,213, -1, -1,213, -1, -1,213,213, -1, -1,213, -1, -1,213, -1, -1,213, -1, -1,213, -1, -1, -1,213,213,213,213,213,213,213,213,213,213, -1, -1, -1, -1, -1, -1, -1, -1, -1, -1, -1, -1, -1, -1, -1, -1, -1, -1, -1, -1, -1,213],
            [213, -1, -1, -1, -1, -1, -1, -1,213,213, -1, -1, -1, -1, -1, -1, -1, -1, -1,213, -1, -1,213, -1, -1,213, -1, -1,213, -1, -1,213,213, -1, -1,213, -1, -1,213, -1, -1,213, -1, -1,213, -1, -1, -1,213,213,213,213,213,213,213,213,213,213, -1, -1, -1, -1, -1, -1, -1, -1, -1, -1, -1, -1, -1, -1, -1, -1, -1, -1, -1, -1, -1,213],
            [213,213,213,213,213,213,213,213,213,213, -1, -1, -1, -1, -1, -1, -1, -1, -1,213, -1, -1,213, -1, -1,213, -1, -1,213, -1, -1,213,213, -1, -1,213, -1, -1,213, -1, -1,213, -1, -1,213, -1, -1, -1,213,213,213,213,213,213,213,213,213,213, -1, -1, -1, -1, -1, -1, -1, -1, -1, -1, -1, -1, -1, -1, -1, -1, -1, -1, -1, -1, -1,213]
    ],
    "spawn_point": {"x":6,"y":22},
    "weapon_spawn_point":[{"x":3, "y":21, "type":"assaultRifle"},{"x":3, "y":21, "type":"assaultRifle"},{"x":58, "y":5, "type":"grenade"},{"x":57, "y":5, "type":"grenade"},{"x":58, "y":5, "type":"grenade"},{"x":59, "y":5, "type":"grenade"},{"x":56, "y":5, "type":"grenade"}],
    "enemy_spawn_point":[{"x":7, "y":14, "type":"ordinaryEnemy","weapon":"pistol"},{"x":3, "y":10, "type":"ordinaryEnemy","weapon":"smg"},{"x":7, "y":6, "type":"ordinaryEnemy","weapon":"revolver"},{"x":13, "y":11, "type":"ordinaryEnemy","weapon":"shotgun"},{"x":40, "y":3, "type":"ordinaryEnemy","weapon":"grenade"},{"x":40, "y":11, "type":"ordinaryEnemy","weapon":"shotgun"},{"x":52, "y":7, "type":"ordinaryEnemy","weapon":"shotgun"},{"x":54, "y":7, "type":"ordinaryEnemy","weapon":"assaultRifle"},{"x":68, "y":15, "type":"ordinaryEnemy","weapon":"assaultRifle"},{"x":65, "y":6, "type":"ordinaryEnemy","weapon":"assaultRifle"},{"x":49, "y":4, "type":"ordinaryEnemy","weapon":"assaultRifle"},{"x":50, "y":4, "type":"ordinaryEnemy","weapon":"assaultRifle"}],
    "bgm": "level1BGM"
}